County,Year,Population,Index Count,Violent Count,Property Count,Firearm Count
Albany,2017,310352,8777,1161,7616,145
Allegany,2017,46878,507,79,428,6
Bronx,2017,1470074,35507,12534,22973,1270
Broome,2017,194923,5568,694,4874,72
Cattaraugus,2017,75611,1158,131,1027,19
Cayuga,2017,77712,1341,237,1104,21
Chautauqua,2017,128942,2786,346,2440,43
Chemung,2017,86084,1567,143,1424,24
Chenango,2017,48397,685,81,604,3
Clinton,2017,81093,1214,136,1078,4
Columbia,2017,60796,970,135,835,19
Cortland,2017,47986,994,49,945,1
Delaware,2017,44468,520,59,461,4
Dutchess,2017,294598,3834,568,3266,73
Erie,2017,923447,23371,3463,19908,930
Essex,2017,36491,419,63,356,6
Franklin,2017,50324,688,100,588,10
Fulton,2017,53556,1087,118,969,9
Genesee,2017,58252,1142,168,974,8
Greene,2017,47352,632,137,495,5
Hamilton,2017,4505,36,4,32,0
Herkimer,2017,62458,1125,155,970,8
Jefferson,2017,113858,2253,235,2018,22
Kings,2017,2646816,49766,14593,35173,1753
Lewis,2017,26893,257,35,222,3
Livingston,2017,64242,809,56,753,3
Madison,2017,71146,983,104,879,8
Monroe,2017,749892,18945,2570,16375,731
Montgomery,2017,49222,938,78,860,5
Nassau,2017,1367901,14016,1650,12366,206
New York,2017,1663498,47146,8671,38475,639
Niagara,2017,211460,5455,766,4689,166
Oneida,2017,231112,4773,694,4079,94
Onondaga,2017,467033,10893,1429,9464,228
Ontario,2017,110349,1622,135,1487,7
Orange,2017,381037,6739,874,5865,120
Orleans,2017,41194,763,86,677,15
Oswego,2017,118741,1980,218,1762,15
Otsego,2017,59891,732,93,639,6
Putnam,2017,98971,628,54,574,2
Queens,2017,2356841,32860,9184,23676,932
Rensselaer,2017,160555,3513,447,3066,90
Richmond,2017,479104,5969,1451,4518,153
Rockland,2017,329966,3404,397,3007,27
Saratoga,2017,228753,2795,279,2516,27
Schenectady,2017,154847,4592,671,3921,100
Schoharie,2017,31166,314,37,277,1
Schuyler,2017,18106,70,15,55,1
Seneca,2017,34779,568,73,495,1
Steuben,2017,96823,1263,171,1092,12
St Lawrence,2017,109995,1512,134,1378,12
Suffolk,2017,1495619,20543,1693,18850,364
Sullivan,2017,74545,1280,221,1059,10
Tioga,2017,48507,456,48,408,3
Tompkins,2017,105637,1949,139,1810,16
Ulster,2017,179106,2550,288,2262,30
Warren,2017,64530,1079,107,972,4
Washington,2017,61690,503,77,426,1
Wayne,2017,90519,1487,186,1301,8
Westchester,2017,980819,11572,1948,9624,291
Wyoming,2017,40666,346,71,275,5
Yates,2017,24910,259,26,233,2
Albany,2016,308401,8767,1099,7668,126
Allegany,2016,46858,571,81,490,5
Bronx,2016,1458255,36834,13817,23017,0
Broome,2016,194518,5422,641,4781,57
Cattaraugus,2016,75126,1232,138,1094,12
Cayuga,2016,77462,1427,184,1243,14
Chautauqua,2016,129139,3327,356,2971,57
Chemung,2016,86124,2064,172,1892,23
Chenango,2016,48229,966,99,867,4
Clinton,2016,80553,1395,135,1260,7
Columbia,2016,60806,834,100,734,12
Cortland,2016,48022,820,43,777,2
Delaware,2016,44601,671,98,573,4
Dutchess,2016,293404,4116,566,3550,70
Erie,2016,917172,25817,3792,22025,1154
Essex,2016,36615,395,57,338,4
Franklin,2016,50135,706,108,598,7
Fulton,2016,53221,1181,149,1032,10
Genesee,2016,58209,1263,127,1136,9
Greene,2016,47019,546,104,442,5
Hamilton,2016,4657,54,5,49,0
Herkimer,2016,62419,1062,121,941,5
Jefferson,2016,117080,2379,281,2098,24
Kings,2016,2641827,50802,15523,35279,0
Lewis,2016,26758,236,30,206,3
Livingston,2016,64186,886,91,795,8
Madison,2016,71064,1027,122,905,5
Monroe,2016,745585,18762,2481,16281,786
Montgomery,2016,49187,1023,83,940,8
Nassau,2016,1356246,15275,1826,13449,314
New York,2016,1647694,46653,8839,37814,0
Niagara,2016,210491,6142,848,5294,162
Oneida,2016,230500,5233,661,4572,111
Onondaga,2016,465564,11116,1415,9701,303
Ontario,2016,109105,1866,164,1702,12
Orange,2016,375993,7313,904,6409,179
Orleans,2016,41061,749,78,671,9
Oswego,2016,118961,2313,265,2048,15
Otsego,2016,59929,779,90,689,7
Putnam,2016,98238,603,37,566,2
Queens,2016,2343667,33800,9356,24444,0
Rensselaer,2016,159384,3658,472,3186,87
Richmond,2016,475474,6313,1589,4724,0
Rockland,2016,326643,3561,384,3177,30
Saratoga,2016,225997,2843,256,2587,13
Schenectady,2016,153524,4682,697,3985,104
Schoharie,2016,30860,385,36,349,2
Schuyler,2016,18042,118,13,105,3
Seneca,2016,34522,643,67,576,5
Steuben,2016,96718,1523,188,1335,8
St Lawrence,2016,110113,1739,173,1566,14
Suffolk,2016,1492991,23090,1896,21194,426
Sullivan,2016,73885,1229,198,1031,22
Tioga,2016,48810,463,63,400,6
Tompkins,2016,104871,1954,158,1796,15
Ulster,2016,178502,2641,295,2346,22
Warren,2016,64064,1201,112,1089,2
Washington,2016,61610,583,95,488,3
Wayne,2016,90389,1618,159,1459,8
Westchester,2016,975138,12537,2113,10424,329
Wyoming,2016,40531,327,48,279,1
Yates,2016,24823,320,17,303,2
Albany,2015,308613,8641,1041,7600,114
Allegany,2015,47336,579,57,522,1
Bronx,2015,1448285,36299,13409,22890,0
Broome,2015,196201,6459,623,5836,71
Cattaraugus,2015,76211,1280,125,1155,6
Cayuga,2015,78420,1553,196,1357,8
Chautauqua,2015,131108,3309,354,2955,40
Chemung,2015,87307,1903,159,1744,21
Chenango,2015,49105,849,101,748,6
Clinton,2015,81364,1251,115,1136,6
Columbia,2015,61779,895,103,792,4
Cortland,2015,48870,751,51,700,3
Delaware,2015,45371,741,80,661,8
Dutchess,2015,295721,4518,558,3960,69
Erie,2015,922022,26091,3788,22303,1022
Essex,2015,36992,382,46,336,3
Franklin,2015,51082,841,88,753,3
Fulton,2015,53542,1309,123,1186,10
Genesee,2015,58705,1199,115,1084,4
Greene,2015,47590,605,117,488,3
Hamilton,2015,4678,43,3,40,0
Herkimer,2015,63446,1020,98,922,4
Jefferson,2015,119514,2543,221,2322,17
Kings,2015,2640252,53957,16385,37572,0
Lewis,2015,27205,282,27,255,4
Livingston,2015,64291,885,77,808,6
Madison,2015,71972,1010,106,904,6
Monroe,2015,749690,20531,2526,18005,727
Montgomery,2015,49555,1264,99,1165,9
Nassau,2015,1360265,16358,1984,14374,368
New York,2015,1647788,47307,2789,35518,0
Niagara,2015,212368,5920,779,5141,145
Oneida,2015,231920,5456,585,4871,110
Onondaga,2015,467471,11574,1500,10074,277
Ontario,2015,109863,1835,144,1691,9
Orange,2015,376037,7244,918,6326,165
Orleans,2015,41689,673,69,604,10
Oswego,2015,120368,2374,251,2123,9
Otsego,2015,60737,841,78,763,4
Putnam,2015,99220,589,43,546,0
Queens,2015,2337925,35920,9854,26066,0
Rensselaer,2015,159567,4200,547,3653,104
Richmond,2015,476611,6465,1651,4814,0
Rockland,2015,326136,3764,483,3281,34
Saratoga,2015,225720,2851,259,2592,9
Schenectady,2015,155634,4623,668,3955,126
Schoharie,2015,31235,402,38,364,5
Schuyler,2015,18488,149,14,135,0
Seneca,2015,34726,730,62,668,4
Steuben,2015,98066,1585,189,1396,13
St Lawrence,2015,111077,1671,143,1528,7
Suffolk,2015,1502075,24496,2010,22486,474
Sullivan,2015,75425,1331,171,1160,15
Tioga,2015,49485,460,54,406,4
Tompkins,2015,105240,2296,147,2149,11
Ulster,2015,179613,3011,304,2707,23
Warren,2015,64672,1090,108,982,6
Washington,2015,62016,613,91,522,3
Wayne,2015,91455,1642,203,1439,15
Westchester,2015,976316,12235,2146,10089,306
Wyoming,2015,40883,422,58,364,5
Yates,2015,25121,299,25,274,1
Albany,2014,308166,9181,1003,8178,147
Allegany,2014,47972,615,68,547,12
Bronx,2014,1440569,36030,12713,23317,0
Broome,2014,197126,6318,496,5822,72
Cattaraugus,2014,76828,1442,133,1309,14
Cayuga,2014,79512,1556,138,1418,14
Chautauqua,2014,132852,3535,296,3239,49
Chemung,2014,88535,2136,151,1985,29
Chenango,2014,49375,909,50,859,8
Clinton,2014,81604,1308,68,1240,5
Columbia,2014,62148,926,47,879,4
Cortland,2014,48983,1081,49,1032,4
Delaware,2014,45709,769,58,711,11
Dutchess,2014,297173,4832,561,4271,106
Erie,2014,921558,28413,3932,24481,1103
Essex,2014,37221,341,44,297,8
Franklin,2014,51796,850,53,797,6
Fulton,2014,54329,1465,63,1402,8
Genesee,2014,59274,1518,112,1406,6
Greene,2014,48364,686,78,608,10
Hamilton,2014,4766,62,1,61,0
Herkimer,2014,64218,1123,110,1013,7
Jefferson,2014,120437,2531,174,2357,13
Kings,2014,2609973,56700,17053,39647,0
Lewis,2014,27211,257,27,230,7
Livingston,2014,64636,896,47,849,4
Madison,2014,72243,1134,61,1073,2
Monroe,2014,752007,21324,2227,19097,711
Montgomery,2014,49874,1251,48,1203,2
Nassau,2014,1357041,17680,2043,15637,437
New York,2014,1635470,47566,8327,39239,0
Niagara,2014,214023,6224,798,5426,183
Oneida,2014,233634,5766,560,5206,155
Onondaga,2014,469355,12957,1493,11464,309
Ontario,2014,109535,2182,130,2052,5
Orange,2014,376716,7853,831,7022,170
Orleans,2014,42149,687,58,629,4
Oswego,2014,121109,2557,159,2398,7
Otsego,2014,61644,837,51,786,7
Putnam,2014,99778,780,51,729,3
Queens,2014,2313385,38030,9800,28230,0
Rensselaer,2014,160303,4259,471,3788,95
Richmond,2014,474541,6865,1551,5314,0
Rockland,2014,323543,3710,370,3340,30
Saratoga,2014,225201,2965,165,2800,12
Schenectady,2014,155678,5092,598,4494,103
Schoharie,2014,31691,380,11,369,0
Schuyler,2014,18529,165,10,155,1
Seneca,2014,35503,721,57,664,2
Steuben,2014,98730,1541,115,1426,5
St Lawrence,2014,112184,1759,97,1662,2
Suffolk,2014,1503376,26121,1765,24356,360
Sullivan,2014,76591,1646,157,1489,23
Tioga,2014,50124,468,27,441,2
Tompkins,2014,104271,2604,103,2501,11
Ulster,2014,180937,3262,293,2969,30
Warren,2014,65353,1209,40,1169,1
Washington,2014,63134,685,60,625,6
Wayne,2014,92302,1603,112,1491,11
Westchester,2014,974944,12106,2149,9957,270
Wyoming,2014,41454,380,36,344,3
Yates,2014,25146,321,18,303,3
Albany,2013,306300,9457,1006,8451,150
Allegany,2013,48220,796,54,742,2
Bronx,2013,1427341,36280,12713,23260,0
Broome,2013,197527,6706,512,6194,53
Cattaraugus,2013,77430,1767,115,1652,20
Cayuga,2013,79520,1517,128,1389,12
Chautauqua,2013,133288,3637,274,3363,40
Chemung,2013,89040,2201,151,2050,18
Chenango,2013,49857,926,48,878,4
Clinton,2013,81595,1666,111,1555,4
Columbia,2013,62398,1127,76,1051,9
Cortland,2013,49599,1064,51,1013,4
Delaware,2013,46322,806,56,750,13
Dutchess,2013,297521,5121,584,4537,112
Erie,2013,920162,29295,4089,25206,1092
Essex,2013,37412,449,43,406,5
Franklin,2013,51936,876,61,815,7
Fulton,2013,54677,1527,62,1465,14
Genesee,2013,59887,1467,109,1358,18
Greene,2013,48582,718,58,660,11
Hamilton,2013,4768,62,4,58,2
Herkimer,2013,64596,1190,126,1064,13
Jefferson,2013,121663,2402,140,2262,15
Kings,2013,2586007,59056,17053,40798,0
Lewis,2013,27307,332,24,308,10
Livingston,2013,64718,1088,56,1032,8
Madison,2013,72132,1156,55,1101,4
Monroe,2013,749775,23076,2686,20390,842
Montgomery,2013,49898,1125,48,1077,1
Nassau,2013,1353478,18684,2111,16573,467
New York,2013,1620452,51872,8327,43164,0
Niagara,2013,214912,6654,798,5856,150
Oneida,2013,233394,5989,537,5452,96
Onondaga,2013,467218,13987,1491,12496,297
Ontario,2013,108796,2094,122,1972,11
Orange,2013,375281,8593,868,7725,165
Orleans,2013,42878,747,59,688,4
Oswego,2013,121698,2678,158,2520,8
Otsego,2013,61617,835,65,770,7
Putnam,2013,99665,772,49,723,3
Queens,2013,2292142,39913,9800,29173,0
Rensselaer,2013,160153,4137,471,3666,90
Richmond,2013,470183,7234,1551,5576,0
Rockland,2013,319900,3806,395,3411,31
Saratoga,2013,223105,3115,173,2942,22
Schenectady,2013,155367,5377,674,4703,116
Schoharie,2013,31944,536,27,509,3
Schuyler,2013,18604,165,14,151,6
Seneca,2013,35375,794,62,732,5
Steuben,2013,99222,1533,123,1410,8
St Lawrence,2013,112480,1965,112,1853,12
Suffolk,2013,1502540,26379,1934,24445,410
Sullivan,2013,76673,1719,172,1547,23
Tioga,2013,50342,650,27,623,0
Tompkins,2013,102977,2902,109,2793,16
Ulster,2013,181804,3580,294,3286,19
Warren,2013,65566,1297,53,1244,1
Washington,2013,62893,882,71,811,10
Wayne,2013,92809,1842,153,1689,20
Westchester,2013,966498,14134,2192,11942,284
Wyoming,2013,41875,510,41,469,6
Yates,2013,25375,413,14,399,0
Albany,2012,305204,9975,1012,8963,137
Allegany,2012,49041,856,65,791,4
Bronx,2012,1404471,35962,12801,23161,0
Broome,2012,200105,6897,604,6293,58
Cattaraugus,2012,78364,2087,149,1938,11
Cayuga,2012,80168,1808,141,1667,8
Chautauqua,2012,135093,3847,308,3539,37
Chemung,2012,89320,2434,222,2212,32
Chenango,2012,50389,1023,58,965,10
Clinton,2012,82387,1685,90,1595,2
Columbia,2012,62888,1425,100,1325,12
Cortland,2012,49629,1105,64,1041,6
Delaware,2012,46974,763,63,700,8
Dutchess,2012,299607,5900,678,5222,105
Erie,2012,922983,31468,4227,27241,1186
Essex,2012,37885,517,43,474,13
Franklin,2012,51829,1042,57,985,4
Fulton,2012,55347,1559,52,1507,9
Genesee,2012,60189,1453,92,1361,6
Greene,2012,49218,721,88,633,5
Hamilton,2012,4819,81,1,80,0
Herkimer,2012,64506,1309,124,1185,7
Jefferson,2012,118546,2917,213,2704,20
Kings,2012,2539714,60690,18673,42017,0
Lewis,2012,27218,420,19,401,3
Livingston,2012,65421,1195,54,1141,7
Madison,2012,73761,1337,59,1278,2
Monroe,2012,749650,25410,2672,22738,789
Montgomery,2012,50185,1185,58,1127,10
Nassau,2012,1351693,19575,2458,17117,450
New York,2012,1608042,51756,9102,42654,0
Niagara,2012,217177,6954,819,6135,144
Oneida,2012,235552,6389,595,5794,90
Onondaga,2012,469480,13645,1752,11893,341
Ontario,2012,109111,2175,150,2025,14
Orange,2012,376895,9499,1077,8422,163
Orleans,2012,42852,920,61,859,6
Oswego,2012,122888,3328,206,3122,20
Otsego,2012,62251,983,78,905,6
Putnam,2012,100472,875,41,834,3
Queens,2012,2261906,40199,10753,29446,0
Rensselaer,2012,160255,4647,447,4200,102
Richmond,2012,475282,7146,1664,5482,0
Rockland,2012,316859,4325,501,3824,57
Saratoga,2012,222074,3241,153,3088,13
Schenectady,2012,155895,5592,691,4901,102
Schoharie,2012,32754,494,19,475,4
Schuyler,2012,18460,185,21,164,6
Seneca,2012,35388,853,59,794,2
Steuben,2012,99568,1837,156,1681,7
St Lawrence,2012,112293,2241,122,2119,14
Suffolk,2012,1506906,28885,2127,26758,437
Sullivan,2012,77315,1931,181,1750,26
Tioga,2012,51319,667,35,632,1
Tompkins,2012,102272,2746,116,2630,14
Ulster,2012,183433,3943,279,3664,32
Warren,2012,66186,1430,125,1305,9
Washington,2012,63506,970,78,892,12
Wayne,2012,93940,1843,132,1711,10
Westchester,2012,961058,15040,2448,12592,340
Wyoming,2012,42170,552,51,501,2
Yates,2012,25591,428,20,408,2
Albany,2011,305571,10726,1164,9562,196
Allegany,2011,49166,895,64,831,4
Bronx,2011,1391333,35130,12267,22863,0
Broome,2011,201502,6643,521,6122,46
Cattaraugus,2011,78771,1925,162,1763,12
Cayuga,2011,80386,1717,182,1535,15
Chautauqua,2011,135511,3687,303,3384,28
Chemung,2011,89229,2278,177,2101,9
Chenango,2011,50704,1072,57,1015,7
Clinton,2011,82497,1690,74,1616,2
Columbia,2011,63380,1234,96,1138,21
Cortland,2011,49558,1104,74,1030,4
Delaware,2011,47349,813,76,737,10
Dutchess,2011,298825,5677,625,5052,91
Erie,2011,923171,31411,4201,27210,1155
Essex,2011,38031,617,47,570,3
Franklin,2011,51831,973,61,912,2
Fulton,2011,55649,1605,61,1544,14
Genesee,2011,60220,1439,112,1327,6
Greene,2011,49442,831,105,726,6
Hamilton,2011,4858,58,1,57,0
Herkimer,2011,64809,1362,141,1221,7
Jefferson,2011,116751,2481,182,2299,22
Kings,2011,2515957,59014,18182,40832,0
Lewis,2011,27209,419,33,386,5
Livingston,2011,65687,1074,44,1030,7
Madison,2011,73772,1284,53,1231,3
Monroe,2011,747689,25666,2661,23005,700
Montgomery,2011,50445,1084,59,1025,4
Nassau,2011,1345553,19374,2226,17148,398
New York,2011,1593000,50858,9021,41837,0
Niagara,2011,217442,7232,810,6422,139
Oneida,2011,235934,5939,551,5388,94
Onondaga,2011,469125,12862,1656,11206,303
Ontario,2011,108416,2103,150,1953,13
Orange,2011,374489,9008,1016,7992,200
Orleans,2011,43076,1003,81,922,5
Oswego,2011,122658,3217,181,3036,17
Otsego,2011,62539,1146,119,1027,18
Putnam,2011,100158,860,66,794,1
Queens,2011,2240748,39863,10311,29552,0
Rensselaer,2011,160146,4687,485,4202,112
Richmond,2011,470837,6801,1428,5373,0
Rockland,2011,313088,4567,554,4013,44
Saratoga,2011,220594,3075,132,2943,8
Schenectady,2011,155422,5529,687,4842,126
Schoharie,2011,32896,433,15,418,3
Schuyler,2011,18425,172,18,154,3
Seneca,2011,35409,681,63,618,3
Steuben,2011,99435,1687,138,1549,9
St Lawrence,2011,112447,2515,143,2372,26
Suffolk,2011,1500062,31406,2217,29189,530
Sullivan,2011,77896,1940,201,1739,24
Tioga,2011,51355,591,34,557,1
Tompkins,2011,102020,2389,90,2299,9
Ulster,2011,183313,3772,335,3437,36
Warren,2011,66002,1494,107,1387,9
Washington,2011,63500,866,96,770,17
Wayne,2011,94193,1709,141,1568,15
Westchester,2011,953379,16283,2557,13726,346
Wyoming,2011,42344,528,37,491,2
Yates,2011,25462,410,13,397,0
Albany,2010,295267,11036,1182,9854,154
Allegany,2010,48531,841,89,752,10
Bronx,2010,1387983,34008,12070,21938,0
Broome,2010,191892,6207,499,5708,64
Cattaraugus,2010,76602,2019,181,1838,10
Cayuga,2010,78400,1765,158,1607,17
Chautauqua,2010,131411,3865,312,3553,41
Chemung,2010,87073,2080,203,1877,32
Chenango,2010,49978,983,54,929,8
Clinton,2010,80874,1830,87,1743,9
Columbia,2010,60786,1213,94,1119,10
Cortland,2010,47401,1066,65,1001,6
Delaware,2010,43997,765,62,703,10
Dutchess,2010,291541,5937,724,5213,118
Erie,2010,895158,32568,4528,28040,1144
Essex,2010,35964,523,37,486,6
Franklin,2010,49634,943,57,886,3
Fulton,2010,54344,1689,123,1566,24
Genesee,2010,56871,1462,107,1355,9
Greene,2010,48478,836,92,744,6
Hamilton,2010,4824,52,4,48,1
Herkimer,2010,61330,1374,169,1205,15
Jefferson,2010,118131,2434,220,2214,31
Kings,2010,2550004,57172,16514,40658,0
Lewis,2010,25785,462,25,437,5
Livingston,2010,62020,1157,47,1110,3
Madison,2010,69222,1295,53,1242,8
Monroe,2010,724942,26186,2823,23363,817
Montgomery,2010,47969,1163,72,1091,4
Nassau,2010,1344303,20320,2344,17976,404
New York,2010,1618207,51297,8829,42468,0
Niagara,2010,211650,7209,835,6374,124
Oneida,2010,228059,6238,587,5651,115
Onondaga,2010,449339,13005,1608,11397,355
Ontario,2010,105010,1995,128,1867,7
Orange,2010,383475,9079,996,8083,152
Orleans,2010,41377,1063,79,984,5
Oswego,2010,119906,3288,189,3099,16
Otsego,2010,60905,1145,126,1019,13
Putnam,2010,98472,934,69,865,7
Queens,2010,2291352,38808,9725,29083,0
Rensselaer,2010,154087,4853,546,4307,93
Richmond,2010,488456,6819,1351,5468,0
Rockland,2010,298092,4766,460,4306,61
Saratoga,2010,219519,3236,151,3085,4
Schenectady,2010,151036,6021,748,5273,145
Schoharie,2010,31169,467,17,450,1
Schuyler,2010,18455,198,11,187,0
Seneca,2010,33740,660,52,608,1
Steuben,2010,95252,1837,164,1673,8
St Lawrence,2010,108273,2482,141,2341,14
Suffolk,2010,1511183,32638,2377,30261,542
Sullivan,2010,75137,1708,219,1489,18
Tioga,2010,49341,600,36,564,6
Tompkins,2010,101158,2505,120,2385,14
Ulster,2010,179764,3839,408,3431,40
Warren,2010,65549,1297,99,1198,4
Washington,2010,62227,884,93,791,12
Wayne,2010,90027,1966,169,1797,14
Westchester,2010,948303,15392,2457,12935,347
Wyoming,2010,40743,476,33,443,6
Yates,2010,24182,474,18,456,1
Albany,2009,298400,10613,1289,9324,191
Allegany,2009,49605,776,129,647,5
Bronx,2009,1398093,33755,11242,22513,0
Broome,2009,194381,6171,458,5713,56
Cattaraugus,2009,77397,1855,184,1671,14
Cayuga,2009,79569,1660,186,1474,20
Chautauqua,2009,133112,3597,256,3341,23
Chemung,2009,87431,2126,161,1965,22
Chenango,2009,50830,997,53,944,7
Clinton,2009,82153,1698,133,1565,4
Columbia,2009,61871,1180,113,1067,17
Cortland,2009,48257,1084,106,978,6
Delaware,2009,45075,754,69,685,7
Dutchess,2009,294145,6095,909,5186,120
Erie,2009,905273,32656,4915,27741,1331
Essex,2009,36495,520,49,471,2
Franklin,2009,50448,937,65,872,8
Fulton,2009,54912,1522,112,1410,18
Genesee,2009,57420,1497,92,1405,12
Greene,2009,49071,851,102,749,11
Hamilton,2009,4980,51,2,49,0
Herkimer,2009,61943,1369,168,1201,9
Jefferson,2009,118766,2701,224,2477,28
Kings,2009,2567968,55816,15803,40013,0
Lewis,2009,26082,387,23,364,2
Livingston,2009,63003,998,69,929,9
Madison,2009,69784,1320,59,1261,8
Monroe,2009,731849,25856,2598,23258,785
Montgomery,2009,48557,726,131,595,10
Nassau,2009,1352956,21828,2496,19332,453
New York,2009,1642066,52899,8710,44189,0
Niagara,2009,213831,7173,847,6326,135
Oneida,2009,231141,6565,644,5921,136
Onondaga,2009,451917,13397,1675,11722,301
Ontario,2009,104919,1870,139,1731,25
Orange,2009,383829,8766,942,7824,127
Orleans,2009,41904,1266,71,1195,8
Oswego,2009,121238,2789,176,2613,20
Otsego,2009,61976,1201,140,1061,8
Putnam,2009,99574,963,85,878,5
Queens,2009,2303205,38925,9299,29626,0
Rensselaer,2009,155511,4809,513,4296,96
Richmond,2009,489575,6962,1303,5659,0
Rockland,2009,299944,4988,473,4515,60
Saratoga,2009,218936,2923,173,2750,15
Schenectady,2009,151942,5830,652,5178,129
Schoharie,2009,31936,572,27,545,3
Schuyler,2009,18839,174,18,156,4
Seneca,2009,34162,651,48,603,5
Steuben,2009,96303,1401,134,1267,3
St Lawrence,2009,109430,1818,194,1624,14
Suffolk,2009,1521962,32604,2740,29864,582
Sullivan,2009,76387,1544,186,1358,15
Tioga,2009,49986,555,30,525,6
Tompkins,2009,101616,2558,153,2405,13
Ulster,2009,182041,3898,445,3453,57
Warren,2009,66247,1444,77,1367,3
Washington,2009,62991,769,60,709,5
Wayne,2009,91270,1774,140,1634,15
Westchester,2009,956850,16636,2482,14154,317
Wyoming,2009,41453,500,47,453,8
Yates,2009,24634,350,11,339,0
Albany,2008,299789,10750,1356,9394,238
Allegany,2008,49594,651,91,560,2
Bronx,2008,1385371,35284,11345,23939,0
Broome,2008,195377,6863,555,6308,43
Cattaraugus,2008,77775,1930,215,1715,16
Cayuga,2008,79812,1853,147,1706,7
Chautauqua,2008,133217,3734,320,3414,35
Chemung,2008,87619,2337,204,2133,23
Chenango,2008,51170,934,41,893,4
Clinton,2008,82475,1819,142,1677,3
Columbia,2008,62256,1336,137,1199,15
Cortland,2008,48328,1106,112,994,4
Delaware,2008,45266,738,74,664,10
Dutchess,2008,294181,6537,892,5645,201
Erie,2008,908651,33375,4735,28640,1299
Essex,2008,36790,467,51,416,3
Franklin,2008,50353,1003,95,908,2
Fulton,2008,55012,1487,99,1388,12
Genesee,2008,57721,1446,113,1333,11
Greene,2008,49358,1418,102,1316,6
Hamilton,2008,5036,41,5,36,0
Herkimer,2008,62313,1285,201,1084,7
Jefferson,2008,117896,2771,271,2500,28
Kings,2008,2549604,59547,16895,42652,0
Lewis,2008,26403,384,35,349,5
Livingston,2008,63029,1075,72,1003,6
Madison,2008,69859,1461,70,1391,7
Monroe,2008,728695,24904,2917,21987,882
Montgomery,2008,48560,785,134,651,5
Nassau,2008,1354833,21075,2309,18766,407
New York,2008,1634686,54731,9176,45555,0
Niagara,2008,214193,7167,763,6404,107
Oneida,2008,231868,6610,672,5938,152
Onondaga,2008,453316,13460,1728,11732,309
Ontario,2008,104379,1897,108,1789,11
Orange,2008,381554,9184,1039,8145,123
Orleans,2008,42138,1107,73,1034,9
Oswego,2008,121286,2593,184,2409,29
Otsego,2008,62469,1102,86,1016,10
Putnam,2008,99894,1052,83,969,4
Queens,2008,2289695,41349,9689,31660,0
Rensselaer,2008,155621,4770,547,4223,89
Richmond,2008,485719,7508,1325,6183,0
Rockland,2008,298129,5047,542,4505,36
Saratoga,2008,217656,3140,161,2979,9
Schenectady,2008,151325,5643,740,4903,174
Schoharie,2008,32113,605,22,583,1
Schuyler,2008,18989,207,15,192,1
Seneca,2008,34332,665,46,619,5
Steuben,2008,96608,1498,161,1337,1
St Lawrence,2008,109530,2327,210,2117,6
Suffolk,2008,1522727,34015,2613,31402,568
Sullivan,2008,76571,1806,195,1611,11
Tioga,2008,50281,580,36,544,4
Tompkins,2008,101591,2475,137,2338,20
Ulster,2008,182305,3670,459,3211,33
Warren,2008,66478,1614,111,1503,4
Washington,2008,62944,911,119,792,6
Wayne,2008,90960,2008,185,1823,8
Westchester,2008,954255,16723,2414,14309,319
Wyoming,2008,41742,547,52,495,9
Yates,2008,24542,284,15,269,1
Albany,2007,297154,10584,1468,9116,208
Allegany,2007,50178,710,86,624,6
Bronx,2007,1364553,36053,11689,24364,0
Broome,2007,195161,6023,459,5564,33
Cattaraugus,2007,79103,2114,149,1965,25
Cayuga,2007,80918,1847,172,1675,16
Chautauqua,2007,134387,3805,341,3464,38
Chemung,2007,88057,2606,224,2382,28
Chenango,2007,51696,970,47,923,4
Clinton,2007,82260,2015,221,1794,4
Columbia,2007,62763,1362,149,1213,17
Cortland,2007,48336,1285,116,1169,14
Delaware,2007,45894,848,91,757,8
Dutchess,2007,296416,6421,895,5526,167
Erie,2007,914914,33249,4541,28708,1231
Essex,2007,37259,540,80,460,2
Franklin,2007,50805,997,145,852,13
Fulton,2007,55242,1615,132,1483,14
Genesee,2007,58342,1441,87,1354,6
Greene,2007,49912,1140,176,964,5
Hamilton,2007,5117,54,2,52,0
Herkimer,2007,63007,1191,177,1014,8
Jefferson,2007,114354,2535,288,2247,17
Kings,2007,2515380,59321,17526,41795,0
Lewis,2007,26568,409,65,344,2
Livingston,2007,63964,1561,61,1500,7
Madison,2007,70109,1434,74,1360,4
Monroe,2007,728081,25278,2956,22322,962
Montgomery,2007,48895,724,118,606,4
Nassau,2007,1320440,20020,2341,17679,398
New York,2007,1611158,55098,10055,45043,0
Niagara,2007,215039,6955,763,6192,104
Oneida,2007,233118,6915,700,6215,126
Onondaga,2007,455272,13260,1815,11445,380
Ontario,2007,104638,1814,99,1715,8
Orange,2007,380352,8781,1042,7739,118
Orleans,2007,42956,1091,91,1000,8
Oswego,2007,122810,2641,160,2481,18
Otsego,2007,62542,1185,100,1085,6
Putnam,2007,100963,983,71,912,1
Queens,2007,2252334,42630,9846,32784,0
Rensselaer,2007,155251,4539,495,4044,84
Richmond,2007,476771,6839,1337,5502,0
Rockland,2007,295219,4477,545,3932,35
Saratoga,2007,216944,3033,205,2828,5
Schenectady,2007,150599,5355,689,4666,133
Schoharie,2007,32193,567,33,534,1
Schuyler,2007,19382,167,19,148,1
Seneca,2007,34827,565,46,519,2
Steuben,2007,97881,1551,160,1391,4
St Lawrence,2007,110894,2318,196,2122,9
Suffolk,2007,1472242,31374,2657,28717,549
Sullivan,2007,76742,2067,268,1799,19
Tioga,2007,51076,533,35,498,5
Tompkins,2007,100687,2452,116,2336,8
Ulster,2007,182932,3473,455,3018,38
Warren,2007,66304,1629,109,1520,8
Washington,2007,63536,1003,128,875,10
Wayne,2007,92504,1784,162,1622,10
Westchester,2007,950091,16786,2478,14308,303
Wyoming,2007,42384,641,54,587,2
Yates,2007,24679,337,13,324,0
Albany,2006,298210,11935,1545,10390,200
Allegany,2006,50737,839,119,720,6
Bronx,2006,1363555,36655,11922,24733,0
Broome,2006,197474,6625,504,6121,39
Cattaraugus,2006,80814,2239,165,2074,17
Cayuga,2006,81672,1960,176,1784,18
Chautauqua,2006,136774,3652,330,3322,36
Chemung,2006,89752,2580,193,2387,25
Chenango,2006,51894,1108,96,1012,3
Clinton,2006,82267,1805,128,1677,7
Columbia,2006,63792,1323,125,1198,9
Cortland,2006,48752,1169,112,1057,4
Delaware,2006,46826,805,78,727,3
Dutchess,2006,295638,5973,854,5119,168
Erie,2006,933195,32581,5015,27566,1450
Essex,2006,37515,552,55,497,2
Franklin,2006,51170,965,157,808,9
Fulton,2006,55675,1517,100,1417,13
Genesee,2006,59301,1754,106,1648,4
Greene,2006,49815,969,183,786,5
Hamilton,2006,5242,74,6,68,0
Herkimer,2006,63951,1348,218,1130,5
Jefferson,2006,116696,3093,300,2793,25
Kings,2006,2490325,61368,17992,43376,0
Lewis,2006,26642,348,26,322,1
Livingston,2006,64377,1963,92,1871,10
Madison,2006,70525,1225,66,1159,7
Monroe,2006,735330,27682,3273,24409,1365
Montgomery,2006,49099,815,131,684,4
Nassau,2006,1336706,21231,2578,18653,468
New York,2006,1600341,56255,10662,45593,0
Niagara,2006,217589,7120,900,6220,175
Oneida,2006,234732,6369,664,5705,107
Onondaga,2006,459279,14204,1885,12319,392
Ontario,2006,104741,1889,130,1759,9
Orange,2006,373891,8351,971,7380,96
Orleans,2006,43503,940,89,851,3
Oswego,2006,123703,2736,158,2578,15
Otsego,2006,62914,1192,146,1046,11
Putnam,2006,100776,963,93,870,11
Queens,2006,2245375,44108,10102,34006,0
Rensselaer,2006,155667,4695,559,4136,109
Richmond,2006,465405,7136,1408,5728,0
Rockland,2006,293700,4746,507,4239,32
Saratoga,2006,215434,3287,244,3043,10
Schenectady,2006,149477,6185,799,5386,157
Schoharie,2006,32363,479,28,451,2
Schuyler,2006,19394,213,12,201,1
Seneca,2006,34948,590,46,544,1
Steuben,2006,98896,1770,259,1511,10
St Lawrence,2006,111678,2699,158,2541,8
Suffolk,2006,1478876,32596,3100,29496,619
Sullivan,2006,76744,2004,291,1713,26
Tioga,2006,51613,587,37,550,3
Tompkins,2006,100286,2720,147,2573,10
Ulster,2006,183182,3919,512,3407,24
Warren,2006,65724,1817,112,1705,2
Washington,2006,63193,1073,96,977,6
Wayne,2006,92018,2267,165,2102,9
Westchester,2006,943326,17678,2768,14910,406
Wyoming,2006,42807,753,100,653,6
Yates,2006,24822,373,23,350,1
Albany,2005,298859,12119,1615,10504,260
Allegany,2005,50647,1069,134,935,4
Bronx,2005,1355320,39024,12325,26699,0
Broome,2005,197979,6129,409,5720,31
Cattaraugus,2005,83298,2394,200,2194,22
Cayuga,2005,82033,1848,138,1710,5
Chautauqua,2005,137464,4003,390,3613,33
Chemung,2005,90113,2813,211,2602,19
Chenango,2005,51935,1103,104,999,2
Clinton,2005,81992,2011,173,1838,7
Columbia,2005,63759,1098,89,1009,7
Cortland,2005,49076,1396,130,1266,3
Delaware,2005,47396,747,82,665,12
Dutchess,2005,293815,6023,826,5197,99
Erie,2005,937659,34458,5017,29441,1353
Essex,2005,38957,549,53,496,4
Franklin,2005,51082,867,155,712,8
Fulton,2005,55542,1607,109,1498,11
Genesee,2005,59775,1693,96,1597,7
Greene,2005,49265,828,133,695,2
Hamilton,2005,5234,84,3,81,1
Herkimer,2005,63949,1468,210,1258,9
Jefferson,2005,111627,3061,290,2771,19
Kings,2005,2475286,66239,19369,46870,0
Lewis,2005,26602,366,28,338,0
Livingston,2005,64912,1902,66,1836,3
Madison,2005,70508,1298,83,1215,10
Monroe,2005,736230,27779,2735,25044,1046
Montgomery,2005,49354,875,122,753,4
Nassau,2005,1341560,20760,2565,18195,487
New York,2005,1590675,59682,11180,48502,0
Niagara,2005,218372,7297,970,6327,208
Oneida,2005,235299,6301,514,5787,53
Onondaga,2005,460464,13906,1969,11937,395
Ontario,2005,103652,1725,110,1615,17
Orange,2005,370883,8169,976,7193,145
Orleans,2005,44201,745,108,637,3
Oswego,2005,123953,2659,187,2472,8
Otsego,2005,62608,1196,112,1084,10
Putnam,2005,100714,1112,95,1017,5
Queens,2005,2231815,45122,10250,34872,0
Rensselaer,2005,154298,4421,490,3931,61
Richmond,2005,462594,7065,1499,5566,0
Rockland,2005,294047,4758,541,4217,45
Saratoga,2005,213011,2870,269,2601,13
Schenectady,2005,148254,5764,708,5056,154
Schoharie,2005,32058,498,33,465,5
Schuyler,2005,19533,341,30,311,2
Seneca,2005,35125,587,37,550,0
Steuben,2005,98956,2153,202,1951,3
St Lawrence,2005,111465,2673,174,2499,6
Suffolk,2005,1477602,32092,3109,28983,680
Sullivan,2005,76219,2221,260,1961,22
Tioga,2005,51609,513,29,484,2
Tompkins,2005,100278,2812,147,2665,23
Ulster,2005,182039,4062,558,3504,35
Warren,2005,65240,1566,89,1477,7
Washington,2005,62897,909,97,812,6
Wayne,2005,93995,2218,171,2047,7
Westchester,2005,943794,17345,2648,14697,376
Wyoming,2005,43048,704,83,621,1
Yates,2005,24704,302,19,283,0
Albany,2004,298419,12710,1431,11279,194
Allegany,2004,50659,943,97,846,4
Bronx,2004,1369123,40939,12797,28142,0
Broome,2004,199744,5909,328,5581,28
Cattaraugus,2004,83515,2481,211,2270,16
Cayuga,2004,81883,1770,131,1639,10
Chautauqua,2004,137910,3804,347,3457,32
Chemung,2004,90587,3070,253,2817,27
Chenango,2004,51759,1096,119,977,2
Clinton,2004,81523,1588,187,1401,4
Columbia,2004,63527,1082,74,1008,4
Cortland,2004,48785,1374,107,1267,6
Delaware,2004,47317,844,88,756,4
Dutchess,2004,291445,5310,747,4563,92
Erie,2004,943107,33304,4715,28589,1068
Essex,2004,39067,470,61,409,4
Franklin,2004,51154,1029,165,864,2
Fulton,2004,55312,1499,95,1404,13
Genesee,2004,60136,1825,108,1717,10
Greene,2004,48959,803,140,663,6
Hamilton,2004,5288,57,4,53,0
Herkimer,2004,63827,1177,177,1000,10
Jefferson,2004,114872,2281,230,2051,13
Kings,2004,2479004,67962,19735,48227,0
Lewis,2004,26687,317,26,291,0
Livingston,2004,64783,1725,86,1639,10
Madison,2004,70317,1404,71,1333,4
Monroe,2004,738157,30947,2332,28615,942
Montgomery,2004,49466,726,56,670,5
Nassau,2004,1342044,22317,2501,19816,415
New York,2004,1563556,62731,11414,51317,0
Niagara,2004,218570,7860,895,6965,135
Oneida,2004,234825,6398,546,5852,63
Onondaga,2004,461404,14241,1674,12567,295
Ontario,2004,102642,1806,88,1718,13
Orange,2004,363853,7360,930,6430,92
Orleans,2004,43713,646,71,575,1
Oswego,2004,123733,2632,136,2496,9
Otsego,2004,62316,1206,129,1077,9
Putnam,2004,99742,1089,77,1012,4
Queens,2004,2227863,48142,10323,37819,0
Rensselaer,2004,154304,4318,488,3830,52
Richmond,2004,461775,7102,1419,5683,0
Rockland,2004,293553,5232,571,4661,63
Saratoga,2004,210222,2851,248,2603,11
Schenectady,2004,147573,5418,613,4805,125
Schoharie,2004,31746,523,45,478,0
Schuyler,2004,19492,347,12,335,6
Seneca,2004,35251,586,37,549,0
Steuben,2004,99203,2093,188,1905,10
St Lawrence,2004,111870,2644,144,2500,6
Suffolk,2004,1470865,32016,2844,29172,512
Sullivan,2004,75092,1880,273,1607,17
Tioga,2004,51846,546,29,517,1
Tompkins,2004,101606,2263,116,2147,5
Ulster,2004,181460,3905,467,3438,24
Warren,2004,64840,1457,98,1359,7
Washington,2004,61991,774,86,688,2
Wayne,2004,93909,2182,197,1985,8
Westchester,2004,942114,18622,2601,16021,326
Wyoming,2004,43015,681,58,623,3
Yates,2004,24768,326,30,296,2
Albany,2003,296677,11977,1402,10575,183
Allegany,2003,50266,846,100,746,3
Bronx,2003,1352377,43071,13381,29690,0
Broome,2003,200665,6062,407,5655,36
Cattaraugus,2003,83411,2325,205,2120,19
Cayuga,2003,81701,1813,186,1627,17
Chautauqua,2003,138567,3966,347,3619,52
Chemung,2003,90768,2916,277,2639,31
Chenango,2003,51411,1228,112,1116,0
Clinton,2003,81207,1599,167,1432,5
Columbia,2003,63640,887,64,823,4
Cortland,2003,48897,1366,95,1271,6
Delaware,2003,47382,937,111,826,9
Dutchess,2003,288241,6225,786,5439,94
Erie,2003,946656,34622,4843,29779,1184
Essex,2003,39001,568,51,517,0
Franklin,2003,51051,1003,193,810,4
Fulton,2003,55143,1288,82,1206,12
Genesee,2003,59901,1778,115,1663,17
Greene,2003,48621,718,152,566,5
Hamilton,2003,5304,71,3,68,0
Herkimer,2003,63849,1409,226,1183,6
Jefferson,2003,108344,2190,197,1993,15
Kings,2003,2494204,71289,21485,49804,0
Lewis,2003,26718,344,47,297,0
Livingston,2003,64934,1773,95,1678,8
Madison,2003,69908,1266,82,1184,6
Monroe,2003,739678,31688,2623,29065,1119
Montgomery,2003,49471,694,46,648,1
Nassau,2003,1347179,22943,2598,20345,470
New York,2003,1546731,64456,12179,52277,0
Niagara,2003,218470,7613,879,6734,122
Oneida,2003,235366,6394,700,5694,117
Onondaga,2003,461560,16123,1762,14361,311
Ontario,2003,101740,2103,118,1985,10
Orange,2003,357380,7902,932,6970,76
Orleans,2003,43966,498,70,428,5
Oswego,2003,123141,2538,142,2396,10
Otsego,2003,62176,1178,133,1045,10
Putnam,2003,98424,1188,79,1109,6
Queens,2003,2243164,50442,11106,39336,0
Rensselaer,2003,153560,4636,528,4108,60
Richmond,2003,461590,6957,1297,5660,0
Rockland,2003,292331,4946,554,4392,58
Saratoga,2003,207487,2629,197,2432,13
Schenectady,2003,147370,4788,554,4234,115
Schoharie,2003,31909,648,40,608,3
Schuyler,2003,19408,322,21,301,5
Seneca,2003,35035,606,44,562,0
Steuben,2003,99482,1516,126,1390,7
St Lawrence,2003,111362,2579,216,2363,8
Suffolk,2003,1461136,35391,2975,32416,618
Sullivan,2003,74399,2106,294,1812,17
Tioga,2003,51860,600,32,568,4
Tompkins,2003,99376,2294,128,2166,10
Ulster,2003,180292,4026,582,3444,42
Warren,2003,64015,1600,135,1465,16
Washington,2003,61299,1016,185,831,7
Wayne,2003,94238,2255,145,2110,17
Westchester,2003,938873,19498,2616,16882,409
Wyoming,2003,43238,1006,80,926,2
Yates,2003,24565,360,30,330,0
Albany,2002,297376,12784,1706,11078,224
Allegany,2002,50404,862,116,746,8
Bronx,2002,1325890,44035,14112,29923,0
Broome,2002,202449,6288,468,5820,46
Cattaraugus,2002,84756,2102,215,1887,13
Cayuga,2002,82745,1844,165,1679,6
Chautauqua,2002,141084,3575,339,3236,23
Chemung,2002,91939,3035,308,2727,39
Chenango,2002,51891,1283,117,1166,11
Clinton,2002,80656,1552,231,1321,6
Columbia,2002,63696,1073,114,959,18
Cortland,2002,49062,1513,93,1420,4
Delaware,2002,48513,936,135,801,7
Dutchess,2002,282823,5968,696,5272,116
Erie,2002,959333,32269,4635,27634,1101
Essex,2002,39222,672,64,608,6
Franklin,2002,51622,1059,197,862,5
Fulton,2002,55598,1495,74,1421,4
Genesee,2002,60946,1683,108,1575,4
Greene,2002,48655,810,146,664,3
Hamilton,2002,5431,110,7,103,0
Herkimer,2002,65041,1414,211,1203,9
Jefferson,2002,112804,2060,217,1843,13
Kings,2002,2538594,73707,22466,51241,0
Lewis,2002,27201,336,40,296,0
Livingston,2002,64942,1614,79,1535,1
Madison,2002,70104,1366,77,1289,6
Monroe,2002,742360,30543,2303,28240,908
Montgomery,2002,50183,799,86,713,6
Nassau,2002,1347279,23197,2705,20492,429
New York,2002,1641192,68152,13211,54941,0
Niagara,2002,221944,7964,815,7149,110
Oneida,2002,237716,6787,689,6098,97
Onondaga,2002,462710,17634,1966,15668,312
Ontario,2002,101181,2067,102,1965,18
Orange,2002,344624,8721,1239,7482,145
Orleans,2002,44592,649,95,554,5
Oswego,2002,123545,3077,183,2894,17
Otsego,2002,62265,1150,159,991,14
Putnam,2002,96658,1282,73,1209,3
Queens,2002,2158613,56889,12625,44264,0
Rensselaer,2002,153993,4953,547,4406,84
Richmond,2002,420404,7848,1426,6422,0
Rockland,2002,289489,5409,649,4760,58
Saratoga,2002,202550,2860,262,2598,28
Schenectady,2002,147953,5157,563,4594,104
Schoharie,2002,31884,640,67,573,3
Schuyler,2002,19407,324,29,295,7
Seneca,2002,33661,636,55,581,0
Steuben,2002,99668,1417,122,1295,6
St Lawrence,2002,112999,2523,264,2259,8
Suffolk,2002,1432913,36706,3123,33583,600
Sullivan,2002,74672,1837,256,1581,30
Tioga,2002,52278,610,38,572,3
Tompkins,2002,97422,3005,132,2873,5
Ulster,2002,179445,4106,525,3581,26
Warren,2002,63907,1892,122,1770,16
Washington,2002,61624,1123,213,910,0
Wayne,2002,94660,2020,135,1885,12
Westchester,2002,932270,19948,2575,17373,379
Wyoming,2002,43838,1145,72,1073,2
Yates,2002,24856,389,30,359,1
Albany,2001,295107,13733,1649,12084,252
Allegany,2001,50019,900,143,757,3
Bronx,2001,1315775,46367,14793,31574,2057
Broome,2001,200905,5830,443,5387,47
Cattaraugus,2001,84109,1897,190,1707,7
Cayuga,2001,82114,1906,177,1729,6
Chautauqua,2001,140007,3631,350,3281,23
Chemung,2001,91238,2814,251,2563,28
Chenango,2001,51496,1235,130,1105,5
Clinton,2001,80041,1451,202,1249,2
Columbia,2001,63210,1074,116,958,14
Cortland,2001,48688,1587,101,1486,3
Delaware,2001,48143,812,113,699,15
Dutchess,2001,280666,6118,627,5491,72
Erie,2001,952014,35182,4572,30610,1032
Essex,2001,38922,719,58,661,3
Franklin,2001,51228,1018,199,819,1
Fulton,2001,55174,1476,93,1383,6
Genesee,2001,60481,1585,96,1489,6
Greene,2001,48284,931,175,756,8
Hamilton,2001,5389,100,3,97,0
Herkimer,2001,64546,1341,171,1170,2
Jefferson,2001,111944,2212,174,2038,16
Kings,2001,2519228,77831,25226,52605,4091
Lewis,2001,26994,316,44,272,0
Livingston,2001,64446,1642,66,1576,6
Madison,2001,69569,1454,99,1355,4
Monroe,2001,736696,30236,2096,28140,816
Montgomery,2001,49799,931,101,830,7
Nassau,2001,1337000,23077,2671,20406,463
New York,2001,1628673,72996,14248,58748,1606
Niagara,2001,220251,7946,733,7213,119
Oneida,2001,235902,6726,602,6124,90
Onondaga,2001,459179,17509,2023,15486,272
Ontario,2001,100408,2011,97,1914,8
Orange,2001,341995,8601,1036,7565,111
Orleans,2001,44252,572,65,507,5
Oswego,2001,122602,2994,116,2878,10
Otsego,2001,61789,910,117,793,25
Putnam,2001,95921,1099,91,1008,7
Queens,2001,2142146,59338,12991,46347,1870
Rensselaer,2001,152819,4662,458,4204,59
Richmond,2001,417196,7693,1479,6214,141
Rockland,2001,287281,6099,719,5380,56
Saratoga,2001,201004,3168,265,2903,32
Schenectady,2001,146825,5478,619,4859,111
Schoharie,2001,31640,633,46,587,8
Schuyler,2001,19259,390,31,359,5
Seneca,2001,33403,606,57,549,4
Steuben,2001,98908,2025,120,1905,6
St. Lawrence,2001,112137,2526,225,2301,6
Suffolk,2001,1421981,37655,3326,34329,662
Sullivan,2001,74102,1817,259,1558,16
Tioga,2001,51879,542,31,511,2
Tompkins,2001,96679,2614,121,2493,10
Ulster,2001,178076,3500,359,3141,14
Warren,2001,63419,1772,101,1671,7
Washington,2001,61154,960,195,765,4
Wayne,2001,93938,2113,139,1974,13
Westchester,2001,925158,21591,2789,18802,381
Wyoming,2001,43504,1185,102,1083,4
Yates,2001,24666,348,19,329,0
Albany,2000,304521,14096,1353,12743,153
Allegany,2000,52720,964,143,821,4
Bronx,2000,1270428,49537,16482,33055,2282
Broome,2000,203614,6043,420,5623,45
Cattaraugus,2000,88097,1881,194,1687,21
Cayuga,2000,85205,1899,175,1724,4
Chautauqua,2000,143321,3946,287,3659,18
Chemung,2000,95670,2861,271,2590,24
Chenango,2000,52877,1173,103,1070,3
Clinton,2000,83139,1415,239,1176,2
Columbia,2000,65702,1128,146,982,10
Cortland,2000,50063,1633,105,1528,1
Delaware,2000,48349,701,104,597,3
Dutchess,2000,279733,6346,609,5737,77
Erie,2000,965641,35471,4545,30926,1074
Essex,2000,39114,767,125,642,1
Franklin,2000,50590,1020,205,815,2
Fulton,2000,55116,1513,134,1379,20
Genesee,2000,63061,1634,85,1549,9
Greene,2000,50420,888,153,735,3
Hamilton,2000,5412,123,7,116,0
Herkimer,2000,66069,1402,163,1239,5
Jefferson,2000,114631,2136,157,1979,11
Kings,2000,2432404,85912,27611,58301,5042
Lewis,2000,28459,262,14,248,1
Livingston,2000,68673,1552,88,1464,7
Madison,2000,74175,1357,90,1267,5
Monroe,2000,742951,31934,2089,29845,735
Montgomery,2000,52528,988,107,881,4
Nassau,2000,1360988,25981,2389,23592,375
New York,2000,1572542,79279,15583,63696,1787
Niagara,2000,225428,7259,725,6534,79
Oneida,2000,239559,6451,577,5874,118
Onondaga,2000,475767,16445,2001,14444,318
Ontario,2000,104068,1976,107,1869,18
Orange,2000,348522,8755,1014,7741,99
Orleans,2000,46952,689,57,632,1
Oswego,2000,129184,2478,111,2367,4
Otsego,2000,63217,1032,134,898,5
Putnam,2000,98909,1071,53,1018,1
Queens,2000,2068318,64662,14349,50313,2053
Rensselaer,2000,157936,4881,481,4400,50
Richmond,2000,402819,8605,1714,6891,242
Rockland,2000,296194,6009,635,5374,59
Saratoga,2000,208293,3026,263,2763,15
Schenectady,2000,150037,5285,559,4726,109
Schoharie,2000,33424,555,26,529,1
Schuyler,2000,20053,423,21,402,5
Seneca,2000,33293,689,31,658,2
Steuben,2000,101886,2049,137,1912,6
St. Lawrence,2000,117690,2808,234,2574,10
Suffolk,2000,1443155,36411,3049,33362,473
Sullivan,2000,72302,2202,285,1917,17
Tioga,2000,54454,507,34,473,3
Tompkins,2000,101841,2558,113,2445,6
Ulster,2000,174463,3963,401,3562,22
Warren,2000,64074,1774,110,1664,10
Washington,2000,62718,1111,206,905,6
Wayne,2000,99615,2151,121,2030,13
Westchester,2000,944382,22034,2624,19410,430
Wyoming,2000,46083,1124,113,1011,5
Yates,2000,25608,348,26,322,1
Albany,1999,292929,14145,1133,13012,113
Allegany,1999,51057,759,94,665,11
Bronx,1999,1218399,49928,16820,33108,2301
Broome,1999,196775,6049,386,5663,34
Cattaraugus,1999,85186,1716,176,1540,6
Cayuga,1999,81359,1996,179,1817,3
Chautauqua,1999,138265,3797,311,3486,32
Chemung,1999,92129,2926,275,2651,28
Chenango,1999,51112,1162,153,1009,3
Clinton,1999,80064,1442,214,1228,0
Columbia,1999,63295,1362,200,1162,18
Cortland,1999,48089,1692,86,1606,2
Delaware,1999,46140,832,102,730,7
Dutchess,1999,265628,6618,603,6015,93
Erie,1999,935566,35890,4162,31728,852
Essex,1999,37592,649,111,538,0
Franklin,1999,48639,928,177,751,2
Fulton,1999,52976,1532,140,1392,5
Genesee,1999,60725,1461,87,1374,5
Greene,1999,47863,1110,219,891,3
Hamilton,1999,5199,135,7,128,1
Herkimer,1999,64124,1450,157,1293,12
Jefferson,1999,111180,2226,165,2061,10
Kings,1999,2332789,89153,28725,60428,5134
Lewis,1999,27526,284,29,255,1
Livingston,1999,66077,1553,112,1441,8
Madison,1999,71152,1264,69,1195,1
Monroe,1999,716911,30524,1943,28581,647
Montgomery,1999,50814,962,107,855,7
Nassau,1999,1303746,28198,2595,25603,570
New York,1999,1508140,81613,16179,65434,2078
Niagara,1999,218326,7391,734,6657,115
Oneida,1999,230898,6588,523,6065,87
Onondaga,1999,458838,16473,1995,14478,251
Ontario,1999,99779,2308,129,2179,4
Orange,1999,329606,8801,1005,7796,104
Orleans,1999,44570,893,94,799,2
Oswego,1999,124151,2763,126,2637,3
Otsego,1999,60859,1373,167,1206,4
Putnam,1999,93467,1220,66,1154,11
Queens,1999,1983613,70598,15700,54898,2341
Rensselaer,1999,152868,4774,461,4313,70
Richmond,1999,386322,8617,1547,7070,200
Rockland,1999,281668,6707,739,5968,76
Saratoga,1999,197838,2935,218,2717,14
Schenectady,1999,145701,5425,570,4855,55
Schoharie,1999,32476,513,43,470,7
Schuyler,1999,19147,451,26,425,3
Seneca,1999,31980,671,40,631,1
Steuben,1999,98065,2427,186,2241,4
St. Lawrence,1999,113821,2848,197,2651,6
Suffolk,1999,1372876,37443,2430,35013,341
Sullivan,1999,69192,2108,235,1873,22
Tioga,1999,52538,614,43,571,3
Tompkins,1999,96133,2710,161,2549,4
Ulster,1999,166546,4072,389,3683,25
Warren,1999,61333,1705,109,1596,7
Washington,1999,60552,1122,193,929,6
Wayne,1999,95088,1953,109,1844,6
Westchester,1999,898972,22710,2740,19970,430
Wyoming,1999,44101,1023,105,918,3
Yates,1999,24230,441,32,409,0
Albany,1998,294930,13733,1310,12423,108
Allegany,1998,51741,891,69,822,10
Bronx,1998,1206670,52464,18391,34073,2623
Broome,1998,199151,6548,386,6162,25
Cattaraugus,1998,85426,2096,154,1942,3
Cayuga,1998,82487,2032,178,1854,11
Chautauqua,1998,140309,4428,390,4038,52
Chemung,1998,93283,3064,258,2806,20
Chenango,1998,52468,1079,136,943,2
Clinton,1998,80828,1373,249,1124,3
Columbia,1998,64217,1502,247,1255,10
Cortland,1998,48947,1865,125,1740,2
Delaware,1998,46653,798,99,699,6
Dutchess,1998,265243,6635,680,5955,85
Erie,1998,946455,39325,4535,34790,876
Essex,1998,38449,646,86,560,2
Franklin,1998,49032,847,173,674,2
Fulton,1998,53399,1596,159,1437,7
Genesee,1998,61938,1419,97,1322,14
Greene,1998,47953,1147,326,821,4
Hamilton,1998,5224,101,1,100,0
Herkimer,1998,65829,1446,141,1305,6
Jefferson,1998,113369,2327,173,2154,12
Kings,1998,2310331,96447,31123,65324,5422
Lewis,1998,28258,469,157,312,0
Livingston,1998,66631,1801,155,1646,7
Madison,1998,71802,1295,54,1241,3
Monroe,1998,719287,34430,2394,32036,912
Montgomery,1998,51561,1147,106,1041,6
Nassau,1998,1306423,27585,2468,25117,455
New York,1998,1493622,89805,18054,71751,2136
Niagara,1998,220711,8762,930,7832,120
Oneida,1998,233677,7237,630,6607,88
Onondaga,1998,462459,17855,1866,15989,206
Ontario,1998,100186,2396,113,2283,11
Orange,1998,327847,8633,1079,7554,92
Orleans,1998,44828,904,116,788,0
Oswego,1998,125578,2885,118,2767,7
Otsego,1998,61609,1171,132,1039,7
Putnam,1998,92576,1289,70,1219,8
Queens,1998,1964518,75665,16492,59173,2459
Rensselaer,1998,154688,4883,413,4470,42
Richmond,1998,382604,9060,1855,7205,182
Rockland,1998,280448,7012,710,6302,77
Saratoga,1998,196997,3011,209,2802,8
Schenectady,1998,147533,5620,563,5057,64
Schoharie,1998,32551,470,33,437,2
Schuyler,1998,19202,359,10,349,2
Seneca,1998,32888,792,66,726,4
Steuben,1998,99265,2725,178,2547,9
St. Lawrence,1998,114420,3008,189,2819,8
Suffolk,1998,1365477,41516,2730,38786,372
Sullivan,1998,70503,2528,277,2251,18
Tioga,1998,53075,751,33,718,0
Tompkins,1998,96849,2823,101,2722,6
Ulster,1998,167283,4207,543,3664,22
Warren,1998,62023,2076,143,1933,8
Washington,1998,60816,1375,247,1128,8
Wayne,1998,95493,2196,130,2066,16
Westchester,1998,898102,25977,2994,22983,421
Wyoming,1998,44690,1166,108,1058,3
Yates,1998,24188,429,22,407,1
Albany,1997,290760,14542,1450,13092,149
Allegany,1997,51151,943,84,859,1
Bronx,1997,1200558,57626,19592,38034,3241
Broome,1997,208158,7023,383,6640,32
Cattaraugus,1997,85411,2300,231,2069,5
Cayuga,1997,82961,2137,168,1969,12
Chautauqua,1997,141908,4669,398,4271,43
Chemung,1997,94352,3320,258,3062,21
Chenango,1997,52239,1362,131,1231,4
Clinton,1997,86819,1916,354,1562,6
Columbia,1997,63282,1734,302,1432,19
Cortland,1997,49278,2020,105,1915,2
Delaware,1997,47642,969,104,865,3
Dutchess,1997,260996,7565,840,6725,88
Erie,1997,965877,44160,5100,39060,1225
Essex,1997,37875,682,80,602,2
Franklin,1997,49028,1089,163,926,2
Fulton,1997,54330,1771,170,1601,9
Genesee,1997,61177,1566,107,1459,7
Greene,1997,47236,1269,337,932,2
Hamilton,1997,5227,106,4,102,0
Herkimer,1997,66686,1506,154,1352,3
Jefferson,1997,114672,2700,166,2534,10
Kings,1997,2298630,101454,32697,68757,5517
Lewis,1997,27558,393,41,352,2
Livingston,1997,64846,1694,143,1551,2
Madison,1997,71575,1645,72,1573,2
Monroe,1997,725650,36659,2912,33747,1328
Montgomery,1997,51998,1162,123,1039,2
Nassau,1997,1298842,29790,2532,27258,542
New York,1997,1486057,100253,20174,80079,2714
Niagara,1997,221217,9300,1027,8273,101
Oneida,1997,249079,7587,693,6894,92
Onondaga,1997,472474,19625,1791,17834,267
Ontario,1997,98592,2319,72,2247,6
Orange,1997,319898,8985,1051,7934,80
Orleans,1997,45530,1080,91,989,6
Oswego,1997,125533,3439,156,3283,10
Otsego,1997,61474,1453,124,1329,2
Putnam,1997,89052,1296,60,1236,5
Queens,1997,1954567,85894,17832,68062,2992
Rensselaer,1997,156057,5483,531,4952,73
Richmond,1997,380665,11346,2571,8775,271
Rockland,1997,274363,7437,746,6691,88
Saratoga,1997,192531,3152,237,2915,16
Schenectady,1997,149311,5676,501,5175,79
Schoharie,1997,32973,526,39,487,1
Schuyler,1997,18977,318,16,302,1
Seneca,1997,32573,749,53,696,1
Steuben,1997,100424,2937,216,2721,6
St. Lawrence,1997,115274,3166,206,2960,4
Suffolk,1997,1345293,44265,2513,41752,402
Sullivan,1997,70502,2887,430,2457,21
Tioga,1997,53325,627,47,580,4
Tompkins,1997,96127,3286,148,3138,14
Ulster,1997,168558,4880,629,4251,42
Warren,1997,61224,2029,133,1896,9
Washington,1997,60670,1298,194,1104,4
Wayne,1997,92812,2143,136,2007,9
Westchester,1997,887311,28601,3146,25455,509
Wyoming,1997,43969,1051,114,937,5
Yates,1997,23866,487,35,452,0
Albany,1996,291536,13676,1408,12268,117
Allegany,1996,51291,1096,93,1003,3
Bronx,1996,1203693,63772,20615,43157,4536
Broome,1996,208713,7483,424,7059,33
Cattaraugus,1996,85642,2381,251,2130,18
Cayuga,1996,83182,2252,163,2089,8
Chautauqua,1996,142287,5151,341,4810,23
Chemung,1996,94605,3610,273,3337,20
Chenango,1996,52382,1418,161,1257,3
Clinton,1996,87051,1985,357,1628,2
Columbia,1996,63454,1711,231,1480,10
Cortland,1996,49410,2242,128,2114,10
Delaware,1996,47772,1121,87,1034,6
Dutchess,1996,261693,7635,935,6700,98
Erie,1996,968442,46220,5546,40674,1299
Essex,1996,37978,728,75,653,2
Franklin,1996,49161,1157,179,978,7
Fulton,1996,54478,2145,174,1971,9
Genesee,1996,61341,1648,126,1522,11
Greene,1996,47365,1222,267,955,5
Hamilton,1996,5241,111,8,103,1
Herkimer,1996,66869,1417,136,1281,3
Jefferson,1996,114980,2886,193,2693,2
Kings,1996,2304633,106659,34798,71861,7117
Lewis,1996,27632,419,34,385,0
Livingston,1996,65021,1719,123,1596,3
Madison,1996,71768,1683,99,1584,5
Monroe,1996,727575,37812,2800,35012,1043
Montgomery,1996,52138,1420,113,1307,5
Nassau,1996,1302292,32413,3268,29145,526
New York,1996,1489938,107398,22006,85392,3725
Niagara,1996,221806,9123,878,8245,71
Oneida,1996,249746,7993,619,7374,83
Onondaga,1996,473732,20303,1729,18574,212
Ontario,1996,98857,2463,84,2379,4
Orange,1996,320759,9809,1145,8664,133
Orleans,1996,45653,959,101,858,2
Oswego,1996,125869,3392,193,3199,5
Otsego,1996,61638,1415,101,1314,5
Putnam,1996,89290,1375,70,1305,3
Queens,1996,1959672,93823,18786,75037,4151
Rensselaer,1996,156474,6044,503,5541,54
Richmond,1996,381658,11951,2523,9428,382
Rockland,1996,275095,7797,658,7139,57
Saratoga,1996,193045,4382,524,3858,11
Schenectady,1996,149708,6122,557,5565,88
Schoharie,1996,33062,588,45,543,6
Schuyler,1996,19028,351,22,329,0
Seneca,1996,32661,785,46,739,3
Steuben,1996,100697,2880,204,2676,7
St. Lawrence,1996,115583,3266,194,3072,6
Suffolk,1996,1348867,45231,2567,42664,452
Sullivan,1996,70692,2939,398,2541,21
Tioga,1996,53468,839,58,781,4
Tompkins,1996,96386,3578,141,3437,19
Ulster,1996,169009,4548,592,3956,22
Warren,1996,61387,2320,201,2119,6
Washington,1996,60834,1150,62,1088,0
Wayne,1996,93063,2056,136,1920,8
Westchester,1996,889681,29486,3227,26259,553
Wyoming,1996,44087,1108,122,986,6
Yates,1996,23930,497,30,467,1
Albany,1995,290756,16699,1606,15093,157
Allegany,1995,51158,1247,160,1087,12
Bronx,1995,1200406,73397,24660,48737,5414
Broome,1995,208154,7010,420,6590,31
Cattaraugus,1995,85416,2677,279,2398,14
Cayuga,1995,82961,2457,233,2224,9
Chautauqua,1995,141908,5425,399,5026,24
Chemung,1995,94353,3545,217,3328,23
Chenango,1995,52245,1405,169,1236,5
Clinton,1995,86818,1873,290,1583,4
Columbia,1995,63286,1756,322,1434,11
Cortland,1995,49280,2101,88,2013,3
Delaware,1995,47647,1153,92,1061,2
Dutchess,1995,260997,7687,1103,6584,131
Erie,1995,965846,49897,8179,41718,1457
Essex,1995,37878,727,74,653,0
Franklin,1995,49030,1267,237,1030,5
Fulton,1995,54334,2276,141,2135,7
Genesee,1995,61178,1759,104,1655,8
Greene,1995,47242,1347,283,1064,2
Hamilton,1995,5228,151,3,148,0
Herkimer,1995,66693,1693,190,1503,4
Jefferson,1995,114677,2464,150,2314,7
Kings,1995,2298337,123733,39887,83846,9578
Lewis,1995,27559,299,25,274,1
Livingston,1995,64849,1674,140,1534,7
Madison,1995,71578,1653,69,1584,3
Monroe,1995,725620,40003,3071,36932,1202
Montgomery,1995,51999,1373,108,1265,2
Nassau,1995,1298798,33229,3198,30031,571
New York,1995,1485868,123638,25095,98543,4565
Niagara,1995,221211,9372,865,8507,87
Oneida,1995,249082,8044,617,7427,100
Onondaga,1995,472465,20489,1804,18685,223
Ontario,1995,98595,2592,128,2464,6
Orange,1995,319910,10406,1174,9232,88
Orleans,1995,45533,859,83,776,8
Oswego,1995,125534,3354,164,3190,1
Otsego,1995,61473,1324,110,1214,6
Putnam,1995,89053,1354,60,1294,11
Queens,1995,1954319,107935,21789,86146,5438
Rensselaer,1995,156057,5565,463,5102,49
Richmond,1995,380616,13829,2749,11080,480
Rockland,1995,274361,8587,767,7820,93
Saratoga,1995,192530,4286,519,3767,16
Schenectady,1995,149307,6645,616,6029,91
Schoharie,1995,32975,586,51,535,1
Schuyler,1995,18977,504,38,466,0
Seneca,1995,32576,791,43,748,3
Steuben,1995,100432,3466,214,3252,9
St. Lawrence,1995,115276,3210,205,3005,7
Suffolk,1995,1345242,47187,2758,44429,479
Sullivan,1995,70504,3031,341,2690,34
Tioga,1995,53326,919,98,821,4
Tompkins,1995,96130,4054,163,3891,15
Ulster,1995,168560,4776,524,4252,29
Warren,1995,61223,2358,281,2077,8
Washington,1995,60674,1395,162,1233,2
Wayne,1995,92816,2333,183,2150,8
Westchester,1995,887306,31001,3572,27429,654
Wyoming,1995,43971,1146,138,1008,3
Yates,1995,23867,551,60,491,2
Albany,1994,293843,16724,1771,14953,162
Allegany,1994,51575,1235,129,1106,2
Bronx,1994,1203141,84330,27863,56467,7498
Broome,1994,213168,7709,437,7272,42
Cattaraugus,1994,85932,2621,279,2342,6
Cayuga,1994,94356,2098,186,1912,10
Chautauqua,1994,142115,5251,450,4801,26
Chemung,1994,95512,3908,260,3648,11
Chenango,1994,52369,1356,196,1160,1
Clinton,1994,86314,1931,224,1707,4
Columbia,1994,63206,1690,241,1449,10
Cortland,1994,49608,2039,99,1940,4
Delaware,1994,47664,1184,76,1108,5
Dutchess,1994,263713,7570,889,6681,119
Erie,1994,975490,51657,8752,42905,1749
Essex,1994,37646,740,91,649,9
Franklin,1994,48122,1193,232,961,7
Fulton,1994,54154,2125,122,2003,8
Genesee,1994,61036,1690,102,1588,6
Greene,1994,46535,1315,271,1044,7
Hamilton,1994,5395,111,5,106,0
Herkimer,1994,66376,1431,163,1268,7
Jefferson,1994,114027,2821,179,2642,12
Kings,1994,2303574,148398,48212,100186,15260
Lewis,1994,27521,262,24,238,1
Livingston,1994,63555,1547,119,1428,4
Madison,1994,71287,1563,48,1515,2
Monroe,1994,726806,37964,3246,34718,1314
Montgomery,1994,52232,1041,70,971,2
Nassau,1994,1306358,34561,3135,31426,678
New York,1994,1489253,151083,31895,119188,7541
Niagara,1994,222338,9366,860,8506,82
Oneida,1994,253006,7896,571,7325,90
Onondaga,1994,475358,19688,1584,18104,190
Ontario,1994,97905,2430,102,2328,4
Orange,1994,316769,9969,1345,8624,132
Orleans,1994,43876,990,66,924,2
Oswego,1994,125283,3387,75,3312,5
Otsego,1994,61185,1243,87,1156,8
Putnam,1994,87473,1391,64,1327,4
Queens,1994,1958772,129050,25412,103638,7559
Rensselaer,1994,156853,5405,483,4922,37
Richmond,1994,381484,17966,3189,14777,764
Rockland,1994,271737,7378,659,6719,70
Saratoga,1994,189002,4154,456,3698,12
Schenectady,1994,150601,6813,783,6030,95
Schoharie,1994,32605,540,47,493,0
Schuyler,1994,18958,338,36,302,1
Seneca,1994,33645,787,47,740,0
Steuben,1994,100455,3303,221,3082,10
St. Lawrence,1994,114189,3446,208,3238,7
Suffolk,1994,1342613,51720,3154,48566,642
Sullivan,1994,70932,3115,381,2734,27
Tioga,1994,53551,1020,137,883,0
Tompkins,1994,95651,4468,134,4334,9
Ulster,1994,169736,5030,593,4437,23
Warren,1994,60682,2349,278,2071,5
Washington,1994,60651,1292,197,1095,1
Wayne,1994,91607,2702,203,2499,14
Westchester,1994,884719,31166,3632,27534,660
Wyoming,1994,43629,1052,171,881,2
Yates,1994,23302,608,52,556,2
Albany,1993,294302,15139,1669,13470,104
Allegany,1993,51659,1265,131,1134,4
Bronx,1993,1204950,91927,31235,60692,9954
Broome,1993,213500,7626,389,7237,31
Cattaraugus,1993,86069,2694,291,2403,13
Cayuga,1993,83056,2203,205,1998,19
Chautauqua,1993,142339,4970,395,4575,24
Chemung,1993,95663,3737,238,3499,15
Chenango,1993,52454,1175,140,1035,2
Clinton,1993,86450,1902,181,1721,3
Columbia,1993,63307,1759,274,1485,13
Cortland,1993,49686,2093,102,1991,4
Delaware,1993,47743,1150,88,1062,7
Dutchess,1993,264128,7908,888,7020,132
Erie,1993,977004,53398,8100,45298,1440
Essex,1993,37707,772,96,676,2
Franklin,1993,48199,1208,177,1031,8
Fulton,1993,54241,2197,123,2074,6
Genesee,1993,61132,1667,92,1575,11
Greene,1993,46611,1402,299,1103,2
Hamilton,1993,5404,128,8,120,0
Herkimer,1993,66483,1469,189,1280,5
Jefferson,1993,114208,2882,187,2695,7
Kings,1993,2307039,169236,54931,114305,20453
Lewis,1993,27565,317,31,286,5
Livingston,1993,63655,1701,135,1566,6
Madison,1993,71400,1520,59,1461,7
Monroe,1993,727933,42439,3132,39307,1220
Montgomery,1993,52315,1013,41,972,1
Nassau,1993,1308384,38965,3567,35398,796
New York,1993,1491493,172021,35470,136551,8766
Niagara,1993,222685,9901,950,8951,85
Oneida,1993,253403,8240,601,7639,88
Onondaga,1993,476098,20263,1716,18547,224
Ontario,1993,98060,2561,162,2399,6
Orange,1993,317272,10093,1195,8898,121
Orleans,1993,43946,1223,99,1124,4
Oswego,1993,125480,3452,97,3355,12
Otsego,1993,61281,1356,96,1260,7
Putnam,1993,87611,1543,79,1464,8
Queens,1993,1961718,149016,28565,120451,9488
Rensselaer,1993,157098,5678,471,5207,46
Richmond,1993,382057,18203,3347,14856,1029
Rockland,1993,272163,7648,618,7030,85
Saratoga,1993,189298,4277,517,3760,20
Schenectady,1993,150837,6406,744,5662,56
Schoharie,1993,32656,587,49,538,3
Schuyler,1993,18988,428,38,390,2
Seneca,1993,33701,656,44,612,0
Steuben,1993,100617,3004,205,2799,9
St. Lawrence,1993,114369,3447,218,3229,10
Suffolk,1993,1344696,59241,3799,55442,895
Sullivan,1993,71045,3111,379,2732,38
Tioga,1993,53635,1116,180,936,3
Tompkins,1993,95802,4869,217,4652,13
Ulster,1993,170006,5048,556,4492,62
Warren,1993,60776,2749,302,2447,4
Washington,1993,60747,1308,215,1093,7
Wayne,1993,91752,2839,178,2661,11
Westchester,1993,886086,32727,3840,28887,678
Wyoming,1993,43699,1151,192,959,4
Yates,1993,23339,553,59,494,2
Albany,1992,295018,16249,1588,14661,116
Allegany,1992,50820,1378,161,1217,10
Bronx,1992,1209516,92551,31050,61501,9898
Broome,1992,213668,6939,365,6574,32
Cattaraugus,1992,84825,2584,322,2262,5
Cayuga,1992,82897,2356,210,2146,9
Chautauqua,1992,142900,5317,296,5021,19
Chemung,1992,95869,4055,298,3757,16
Chenango,1992,52128,1315,125,1190,6
Clinton,1992,86579,2069,210,1859,6
Columbia,1992,63424,1875,269,1606,12
Cortland,1992,49310,2108,110,1998,5
Delaware,1992,47555,1076,85,991,10
Dutchess,1992,261299,9046,1017,8029,146
Erie,1992,975430,56304,8516,47788,1364
Essex,1992,37411,871,88,783,5
Franklin,1992,46868,1063,160,903,8
Fulton,1992,54572,2064,123,1941,5
Genesee,1992,60484,1767,79,1688,2
Greene,1992,45050,1408,261,1147,5
Hamilton,1992,5315,146,2,144,1
Herkimer,1992,66259,1727,193,1534,0
Jefferson,1992,111723,2802,249,2553,10
Kings,1992,2315780,176699,56682,120017,21070
Lewis,1992,26985,298,24,274,1
Livingston,1992,62808,1783,121,1662,1
Madison,1992,69605,1773,86,1687,1
Monroe,1992,719054,44474,2985,41489,1031
Montgomery,1992,52347,991,30,961,4
Nassau,1992,1296521,40203,3718,36485,1058
New York,1992,1497145,187947,37788,150159,9623
Niagara,1992,222326,10088,1087,9001,79
Oneida,1992,252609,9140,617,8523,84
Onondaga,1992,472306,21363,1915,19448,247
Ontario,1992,95773,2517,136,2381,14
Orange,1992,309812,10518,1254,9264,105
Orleans,1992,42140,1311,178,1133,3
Oswego,1992,122633,3553,113,3440,5
Otsego,1992,60947,1247,66,1181,4
Putnam,1992,84535,1673,107,1566,5
Queens,1992,1969950,151896,30816,121080,10936
Rensselaer,1992,155523,5661,375,5286,26
Richmond,1992,382706,18144,3319,14825,1005
Rockland,1992,267362,7715,730,6985,102
Saratoga,1992,182561,5165,566,4599,23
Schenectady,1992,150345,6944,924,6020,64
Schoharie,1992,32082,683,59,624,1
Schuyler,1992,18793,496,35,461,4
Seneca,1992,33920,703,36,667,1
Steuben,1992,99783,3439,244,3195,8
St. Lawrence,1992,112764,3810,233,3577,8
Suffolk,1992,1331288,64042,4218,59824,938
Sullivan,1992,69765,2872,334,2538,17
Tioga,1992,52708,1201,183,1018,2
Tompkins,1992,94762,4770,181,4589,4
Ulster,1992,166468,5211,501,4710,37
Warren,1992,59628,2872,373,2499,2
Washington,1992,59745,1352,189,1163,2
Wayne,1992,89754,2960,187,2773,5
Westchester,1992,881073,34275,3722,30553,619
Wyoming,1992,42804,1179,189,990,8
Yates,1992,22970,548,67,481,2
Albany,1991,294030,15464,1674,13790,120
Allegany,1991,50654,1417,134,1283,4
Bronx,1991,1205404,100071,33515,66556,10927
Broome,1991,212952,7447,339,7108,18
Cattaraugus,1991,84545,2639,273,2366,5
Cayuga,1991,82620,2554,216,2338,13
Chautauqua,1991,142423,5472,227,5245,21
Chemung,1991,95549,4190,256,3934,5
Chenango,1991,51957,1243,97,1146,8
Clinton,1991,86288,2516,269,2247,3
Columbia,1991,63215,2323,363,1960,13
Cortland,1991,49146,2193,83,2110,1
Delaware,1991,47398,1202,75,1127,1
Dutchess,1991,260427,9240,974,8266,139
Erie,1991,972153,55414,8277,47137,989
Essex,1991,37288,899,82,817,3
Franklin,1991,46713,1147,197,950,5
Fulton,1991,54391,2252,123,2129,7
Genesee,1991,60283,1752,107,1645,6
Greene,1991,44903,1626,221,1405,5
Hamilton,1991,5298,158,10,148,0
Herkimer,1991,66040,1608,104,1504,10
Jefferson,1991,111353,3202,202,3000,2
Kings,1991,2307907,191259,60814,130445,21878
Lewis,1991,26895,329,16,313,1
Livingston,1991,62601,1914,151,1763,2
Madison,1991,69375,1851,76,1775,3
Monroe,1991,716639,43858,2857,41001,871
Montgomery,1991,52173,1115,50,1065,1
Nassau,1991,1292164,43219,3848,39371,901
New York,1991,1492055,209177,41209,167968,10741
Niagara,1991,221581,10165,930,9235,78
Oneida,1991,251768,9233,489,8744,60
Onondaga,1991,470722,23254,1916,21338,188
Ontario,1991,95454,2625,90,2535,2
Orange,1991,308786,11207,1263,9944,80
Orleans,1991,42001,1313,151,1162,5
Oswego,1991,122224,3584,136,3448,8
Otsego,1991,60743,1374,62,1312,6
Putnam,1991,84254,1843,109,1734,7
Queens,1991,1962456,160205,31821,128384,11173
Rensselaer,1991,155003,5500,459,5041,20
Richmond,1991,382201,19809,3127,16682,798
Rockland,1991,266466,7910,787,7123,79
Saratoga,1991,181951,5292,558,4734,19
Schenectady,1991,149842,6364,642,5722,43
Schoharie,1991,31976,741,57,684,1
Schuyler,1991,18731,583,30,553,3
Seneca,1991,33807,808,54,754,3
Steuben,1991,99454,3509,200,3309,4
St. Lawrence,1991,112389,3853,209,3644,4
Suffolk,1991,1326812,67697,3989,63708,829
Sullivan,1991,69532,3229,338,2891,10
Tioga,1991,52531,1276,166,1110,4
Tompkins,1991,94446,4862,182,4680,6
Ulster,1991,165915,5184,544,4640,29
Warren,1991,59429,2721,298,2423,3
Washington,1991,59548,1502,209,1293,2
Wayne,1991,89454,3093,197,2896,12
Westchester,1991,878128,37118,3933,33185,774
Wyoming,1991,42663,1220,222,998,3
Yates,1991,22894,678,57,621,1
Albany,1990,292594,14418,1524,12894,122
Allegany,1990,50470,1280,146,1134,1
Bronx,1990,1200900,104729,33635,71094,10869
Broome,1990,212160,7480,306,7174,13
Cattaraugus,1990,84234,2578,171,2407,5
Cayuga,1990,82313,2331,196,2135,13
Chautauqua,1990,141895,5713,229,5484,19
Chemung,1990,95195,3816,284,3532,14
Chenango,1990,51768,1178,78,1100,1
Clinton,1990,85969,2221,242,1979,9
Columbia,1990,62982,1954,253,1701,3
Cortland,1990,48963,2123,96,2027,2
Delaware,1990,47225,1092,73,1019,3
Dutchess,1990,259462,8957,1104,7853,110
Erie,1990,968532,52314,7390,44924,758
Essex,1990,37152,959,78,881,4
Franklin,1990,46540,1166,226,940,7
Fulton,1990,54191,2259,98,2161,8
Genesee,1990,60060,1647,89,1558,3
Greene,1990,44739,1440,205,1235,4
Hamilton,1990,5279,100,4,96,0
Herkimer,1990,65797,1287,77,1210,1
Jefferson,1990,110943,3135,187,2948,2
Kings,1990,2299285,202009,63087,138922,21025
Lewis,1990,26796,322,36,286,10
Livingston,1990,62372,1915,147,1768,16
Madison,1990,69120,1913,60,1853,2
Monroe,1990,713968,42579,3317,39262,749
Montgomery,1990,51981,1015,34,981,2
Nassau,1990,1287348,42142,3223,38919,687
New York,1990,1486480,217786,44434,173352,10304
Niagara,1990,220756,9810,986,8824,73
Oneida,1990,250836,7748,388,7360,29
Onondaga,1990,468973,21823,1746,20077,120
Ontario,1990,95101,2588,121,2467,11
Orange,1990,307647,11125,1339,9786,129
Orleans,1990,41846,1104,159,945,4
Oswego,1990,121771,3374,106,3268,4
Otsego,1990,60517,1214,66,1148,3
Putnam,1990,83941,1903,135,1768,8
Queens,1990,1955125,165179,30441,134738,9832
Rensselaer,1990,154429,5438,401,5037,16
Richmond,1990,380774,21853,3092,18761,675
Rockland,1990,265475,8508,709,7799,42
Saratoga,1990,181276,5152,476,4676,12
Schenectady,1990,149285,5924,387,5537,37
Schoharie,1990,31859,749,52,697,2
Schuyler,1990,18662,646,19,627,3
Seneca,1990,33683,793,52,741,1
Steuben,1990,99088,3410,246,3164,6
St. Lawrence,1990,111974,3541,281,3260,8
Suffolk,1990,1321864,61300,3786,57514,651
Sullivan,1990,69277,3169,300,2869,10
Tioga,1990,52337,915,121,794,4
Tompkins,1990,94097,4495,143,4352,6
Ulster,1990,165304,5542,613,4929,36
Warren,1990,59209,2506,285,2221,3
Washington,1990,59330,1412,180,1232,1
Wayne,1990,89123,2604,179,2425,9
Westchester,1990,874866,38145,3871,34274,647
Wyoming,1990,42507,1354,212,1142,5
Yates,1990,22810,507,34,473,2
